2777777777777127777777777771
8000000000000880000000000008
8027710277710880277710277108
8080080800080880800080800808
8037740377740340377740377408
8000000000000000000000000008
8027710210277777710210277108
8037740880377127740880377408
8000000880000880000880000008
3777710837710880277480277774
0000080827740340377180800000
0000080880000000000880800000
0000080880277007710880800000
7777740340800000080340377777
0000000000800000080000000000
7777710210800000080210277777
0000080880377777740880800000
0000080880000000000880800000
0000080880277777710880800000
2777740340377127740340377771
8000000000000880000000000008
8027710277710880277710277108
8037180377740340377740827408
8000880000000000000000880008
3710880210277777710210880274
2740340880377127740880340371
8000000880000880000880000008
8027777437710880277437777108
8037777777740340377777777408
8000000000000000000000000008
3777777777777777777777777774