2777777777777127777777777771
8DDDDDDDDDDDD88DDDDDDDDDDDD8
8P2771D27771D88D27771D2771P8
8D8008D80008D88D80008D8008D8
8D3774D37774D34D37774D3774D8
8DDDDDDDDDDDDDDDDDDDDDDDDDD8
8D2771D21D27777771D21D2771D8
8D3774D88D37712774D88D3774D8
8DDDDDD88DDDD88DDDD88DDDDDD8
377771D83771088027748D277774
000008D82774034037718D800000
000008D88000000000088D800000
000008D88027700771088D800000
777774D34080000008034D377777
000000D00080000008000D000000
777771D21080000008021D277777
000008D88037777774088D800000
000008D88000000000088D800000
000008D88027777771088D800000
277774D34037712774034D377771
8DDDDDDDDDDDD88DDDDDDDDDDDD8
8D2771D27771D88D27771D2771D8
8D3718D37774D34D37774D8274D8
8DDD88DDDDDDDDDDDDDDDD88DDD8
371D88D21D27777771D21D88D274
274D34D88D37712774D88D34D371
8DDDDDD88DDDD88DDDD88DDDDDD8
8D2777743771D88D2774377771D8
8P3777777774D34D3777777774P8
8DDDDDDDDDDDDDDDDDDDDDDDDDD8
3777777777777777777777777774