2777777777777127777777777771
8eeeeeeeeeeee88eeeeeeeeeeee8
8j2771e27771e88e27771e2771j8
8e8008e80008e88e80008e8008e8
8e3774e37774e34e37774e3774e8
8eeeeeeeeeeeeeeeeeeeeeeeeee8
8e2771e21e27777771e21e2771e8
8e3774e88e37712774e88e3774e8
8eeeeee88eeee88eeee88eeeeee8
377771e83771088027748e277774
000008e82774034037718e800000
000008e88000000000088e800000
000008e88027700771088e800000
777774e34080000008034e377777
000000e00080000008000e000000
777771e21080000008021e277777
000008e88037777774088e800000
000008e88000000000088e800000
000008e88027777771088e800000
277774e34037712774034e377771
8eeeeeeeeeeee88eeeeeeeeeeee8
8e2771e27771e88e27771e2771e8
8e3718e37774e34e37774e8274e8
8eee88eeeeeeeeeeeeeeee88eee8
371e88e21e27777771e21e88e274
274e34e88e37712774e88e34e371
8eeeeee88eeee88eeee88eeeeee8
8e2777743771e88e2774377771e8
8j3777777774e34e3777777774j8
8eeeeeeeeeeeeeeeeeeeeeeeeee8
3777777777777777777777777774