2777777777777127777777777771
8DDDDDDDDDDDD88DDDDDDDDDDDD8
8P2771D27771D88D27771D2771P8
8D8XX8D8XXX8D88D8XXX8D8XX8D8
8D3774D37774D34D37774D3774D8
8DDDDDDDDDDDDDDDDDDDDDDDDDD8
8D2771D21D27777771D21D2771D8
8D3774D88D37712774D88D3774D8
8DDDDDD88DDDD88DDDD88DDDDDD8
377771D83771088027748D277774
XXXXX8D82774034037718D8XXXXX
XXXXX8D88000000000088D8XXXXX
XXXXX8D88027700771088D8XXXXX
777774D34080000008034D377777
XX0000D00080000008000D0000XX
777771D21080000008021D277777
XXXXX8D88037777774088D8XXXXX
XXXXX8D88000000000088D8XXXXX
XXXXX8D88027777771088D8XXXXX
277774D34037712774034D377771
8DDDDDDDDDDDD88DDDDDDDDDDDD8
8D2771D27771D88D27771D2771D8
8D3718D37774D34D37774D8274D8
8DDD88DDDDDDDDDDDDDDDD88DDD8
371D88D21D27777771D21D88D274
274D34D88D37712774D88D34D371
8DDDDDD88DDDD88DDDD88DDDDDD8
8D2777743771D88D2774377771D8
8P3777777774D34D3777777774P8
8DDDDDDDDDDDDDDDDDDDDDDDDDD8
3777777777777777777777777774